5 6 10
1 1 1 1 1 1
1 0 R 0 1 1
1 0 1 0 0 1
1 0 1 0 0 1
1 1 1 1 1 1